0,0,0,0,0,0,0,0,0,0,0,0,0,0,0,0,0,0,0,0,0,0,0,0,0,0,0,0,0,0,0,0,0,0,0,0,0,0,0,0,0,0,0,0,0,0,0,0,0,0,0,0,0,0,0,0,0,0,0,0,0,0,0,0,0,0,0,0,0,0,0,0,0,0,0,0,0,0,0,0,0,0,0,0,0,0,0,0,0,0,0,0,0,0,0,0,0,0,0,0,0,0,0,0,0,0,0,0,0,0
0,0,0,0,0,0,0,0,0,0,0,0,0,0,0,0,0,0,0,0,0,0,0,0,0,0,0,0,0,0,0,0,0,0,0,0,0,0,0,0,0,0,0,0,0,0,0,0,0,0,0,0,0,0,0,0,0,0,0,0,0,0,0,0,0,0,0,0,0,0,0,0,0,0,0,0,0,0,0,0,0,0,0,0,0,0,0,0,0,0,0,0,0,0,0,0,0,0,0,0,0,0,0,0,0,0,0,0,0,0
0,0,0,0,0,0,0,0,0,0,0,0,0,0,0,0,0,0,0,0,0,0,0,0,0,0,0,0,0,0,0,0,0,0,0,0,0,0,0,0,0,0,0,0,0,0,0,0,0,0,0,0,0,0,0,0,0,0,0,0,0,0,0,0,0,0,0,0,0,0,0,0,0,0,0,0,0,0,0,0,0,0,0,0,0,0,0,0,0,0,0,0,0,0,0,0,0,0,0,0,0,0,0,0,0,0,0,0,0,0
0,0,0,0,0,0,0,0,0,0,0,0,0,0,0,0,0,0,0,0,0,0,0,0,0,0,0,0,0,0,0,0,0,0,0,0,0,0,0,0,0,0,0,0,0,0,0,0,0,0,0,0,0,0,0,0,0,0,0,0,0,0,0,0,0,0,0,0,0,0,0,0,0,0,0,0,0,0,0,0,0,0,0,0,0,0,0,0,0,0,0,0,0,0,0,0,0,0,36,0,0,0,0,0,0,0,0,0,0,0
0,0,0,0,0,0,0,0,0,0,0,0,0,0,0,0,0,0,0,0,0,0,0,0,0,0,0,0,0,0,0,0,0,0,0,0,0,0,0,0,0,0,0,0,0,0,0,0,0,0,0,0,0,0,0,0,0,0,0,0,0,0,0,0,0,0,0,0,0,0,0,0,0,0,0,0,0,0,0,0,0,0,0,0,0,0,0,0,0,0,0,0,0,0,0,0,0,0,117,119,0,0,0,0,0,0,0,0,0,0
0,0,0,0,0,0,0,0,0,0,0,0,0,0,0,0,0,0,0,0,0,0,0,0,0,0,0,0,0,0,0,0,0,0,0,0,0,0,0,0,0,0,0,0,0,0,0,0,0,0,0,0,0,0,0,0,0,0,0,0,0,0,0,0,0,0,0,0,0,0,0,0,0,0,0,0,0,0,0,0,0,0,0,0,0,0,0,0,0,0,0,0,0,0,0,0,0,0,118,120,0,0,0,0,0,0,0,0,0,0
0,0,0,0,0,0,0,0,0,0,0,0,0,0,0,0,0,0,0,0,0,0,0,0,0,0,0,0,0,0,0,0,0,0,0,0,0,0,0,0,0,0,0,0,0,0,0,0,0,0,0,0,0,0,0,0,0,0,0,0,0,0,0,0,0,0,0,0,0,0,0,0,0,0,0,0,0,0,0,0,0,0,0,0,0,0,0,0,0,0,0,0,0,0,0,0,89,91,73,75,0,0,0,0,0,0,0,0,0,0
0,0,0,0,0,0,0,0,0,0,0,0,0,0,0,0,0,0,0,0,0,0,0,0,0,0,0,0,0,0,0,0,0,0,0,0,0,0,0,0,0,0,0,0,0,0,0,0,0,0,0,0,0,0,0,0,0,0,0,0,0,0,0,0,0,0,0,0,0,0,0,0,0,0,0,0,0,0,0,0,0,0,0,0,0,0,0,0,0,0,0,0,0,0,0,0,90,92,74,76,0,85,87,0,0,0,0,0,105,107
0,0,0,0,0,0,0,0,0,0,0,0,0,0,0,0,0,0,0,0,0,0,0,0,0,0,0,0,0,0,0,0,0,0,0,0,0,0,0,0,0,0,0,0,0,0,0,0,0,0,0,0,0,0,0,0,0,0,0,0,0,0,0,0,0,0,0,0,0,0,0,0,0,0,0,0,0,0,0,0,0,0,0,0,0,0,0,0,0,0,0,0,0,0,0,133,77,79,41,129,132,86,88,0,101,103,0,0,106,108
0,0,0,0,0,0,0,0,0,0,0,0,0,0,0,0,0,0,0,0,0,0,0,0,0,0,0,0,0,0,0,0,0,0,0,0,0,0,0,0,0,0,0,0,0,0,0,0,0,0,0,0,68,0,0,0,0,0,0,68,0,0,0,0,0,0,0,0,0,0,0,0,0,0,0,0,0,0,0,0,0,0,0,0,0,0,0,0,0,0,69,0,0,73,75,43,78,80,81,83,73,75,129,68,102,104,0,0,81,83
0,0,0,0,0,0,0,0,0,0,0,0,0,0,0,0,0,0,0,0,0,36,0,0,0,0,0,0,0,0,0,0,0,0,0,0,0,0,0,0,0,0,0,0,0,0,0,0,0,134,77,79,126,126,127,121,121,122,120,126,129,117,119,73,75,137,0,0,0,0,0,0,0,0,0,0,0,0,0,0,0,0,0,0,0,0,0,0,0,42,73,75,127,74,76,105,107,0,82,84,74,76,41,131,43,129,43,137,82,84
0,0,0,0,0,0,0,0,0,0,0,0,0,0,36,134,85,87,73,75,121,130,130,130,0,130,130,130,109,111,73,75,124,125,136,0,68,35,0,0,0,0,0,0,0,0,69,135,73,75,78,80,0,0,0,0,0,131,131,127,0,118,120,74,76,81,83,136,0,0,0,0,0,0,135,73,75,0,0,138,69,68,0,133,85,87,41,41,101,103,74,76,41,105,107,106,108,41,97,99,41,129,124,41,105,107,129,85,87,77
0,0,0,0,0,0,0,0,0,0,42,0,0,69,117,119,86,88,74,76,121,125,122,0,0,0,0,124,110,112,74,76,125,123,89,91,105,107,137,0,0,69,0,0,109,111,89,91,74,76,125,128,0,0,0,0,0,125,0,0,0,0,121,89,91,82,84,105,107,109,111,77,79,77,79,74,76,0,125,117,119,123,109,111,86,88,77,79,102,104,0,85,87,106,108,97,99,41,98,100,81,83,131,121,106,108,121,86,88,78
0,0,0,0,0,34,0,68,0,133,122,109,111,121,118,120,122,89,91,105,107,123,0,0,0,0,0,0,113,115,77,79,126,128,90,92,106,108,109,111,121,131,121,44,110,112,90,92,122,132,126,124,81,83,0,0,0,125,0,68,0,135,121,90,92,93,95,106,108,110,112,78,80,78,80,43,125,0,121,118,120,124,110,112,77,79,78,80,41,43,127,86,88,127,41,98,100,77,79,43,82,84,121,122,109,111,73,75,109,111
73,75,73,75,109,111,81,83,89,91,131,110,112,122,117,119,123,90,92,106,108,41,0,0,0,0,0,0,114,116,78,80,127,129,93,95,113,115,110,112,117,119,117,119,85,87,81,83,131,123,105,107,82,84,0,0,0,121,123,117,119,97,99,105,107,94,96,0,101,103,81,83,125,125,123,41,123,0,81,83,127,122,93,95,78,80,109,111,97,99,81,83,97,99,129,43,127,78,80,41,97,99,117,119,110,112,74,76,110,112
74,76,74,76,110,112,82,84,90,92,132,122,121,121,118,120,124,109,111,109,111,125,0,0,0,0,0,0,121,125,81,83,77,79,94,96,114,116,121,41,118,120,118,120,86,88,82,84,123,123,106,108,132,126,124,0,123,123,123,118,120,98,100,106,108,121,125,0,102,104,82,84,123,132,132,0,121,0,82,84,124,127,94,96,81,83,110,112,98,100,82,84,98,100,130,81,83,125,124,81,98,100,118,120,81,83,81,83,122,117
